WWWWWWWWWWWWWWWWWWWWWWWWWWWW
CCCCCCCWWCCCCCCCCCCWWCCCCCCC
WWWWWWCWWCWWWWWWWWCWWCWWWWWW
WWWWWWCWWCWWWWWWWWCWWCWWWWWW
WSCCCCCCCCCCCWWCCCCCCCCCCCSW
WCWWWWWWWCWWCWWCWWCWWWWWWWCW
WCWWWWWWWCWWCWWCWWCWWWWWWWCW
WCWWCCCCCCWWCWWCWWCCCCCCWWCW
WCWWCWWWWCWWCWWCWWCWWWWCWWCW
WCWWCWWWWCWWCCCCWWCWWWWCWWCW
WCCCCCCWWCWWWWWWWWCWWCCCCCCW
WWWWWWCWWEEEEEREEEEWWCWWWWWW
WWWWWWCWWEWWWEEWWWEWWCWWWWWW
WCCCCCCWWEWEEEEEEWEWWCCCCCCW
WCWWWWCWWEWEBEPEYWEWWCWWWWCW
WCWWWWCEEEWEEEEEEWEEECWWWWCW
WCCCWWCCCEWWWWWWWWECCCWWCCCW
WWWCWWCCCEEEEEEEEEECCCWWCWWW
EEWCWWCWWWWEWWWWEWWWWCWWCWEE
EEWCWWCWWWWEWWWWEWWWWEWWCWEE
EEWCCCCCCCCCCCCCCCCCCCCCCWEE
WWWCWWWWWWWCWWWWCWWWWWWWCWWW
WWWCWWWWWWWCWWWWCWWWWWWWCWWW
EEECEEEWWCCCCEMECCCWWEEECEEE
WWWCWWEWWCWWWWWWWWCWWEWWCWWW
WWWCWWEWWCWWWWWWWWCWWEWWCWWW
WSCCWWCCCCCCCWWCCCCCCCWWCCSW
WCCCWWCWWWWWCWWCWWWWWCWWCCCW
WCCCWWCWWWWWCWWCWWWWWCWWCCCW
WCCCCCCCCCCCCCCCCCCCCCCCCCCW
WWWWWWWWWWWWWWWWWWWWWWWWWWWW