WWWWWWWWWWWWWWWWWWWWWWWWWWWW
WCCCCCCCCCCCCWWCCCCCCCCCCCCW
WCWWWWCWWWWWCWWCWWWWWCWWWWCW
WSWWWWCWWWWWCWWCWWWWWCWWWWSW
WCCCCCCCCCCCCCCCCCCCCCCCCCCW
WCWWWWCWWCWWWWWWWWCWWCWWWWCW
WCWWWWCWWCWWWWWWWWCWWCWWWWCW
WCCCCCCWWCCCCWWCCCCWWCCCCCCW
WWWWWWCWWWWWEWWEWWWWWCWWWWWW
EEEEEWCWWWWWEWWEWWWWWCWEEEEE
EEEEEWCWWEEEEEREEEEWWCWEEEEE
EEEEEWCWWEWWWEEWWWEWWCWEEEEE
WWWWWWCWWEWEEEEEEWEWWCWWWWWW
EEEEEECEEEWEBEPEYWEEECEEEEEE
WWWWWWCWWEWEEEEEEWEWWCWWWWWW
EEEEEWCWWEWWWWWWWWEWWCWEEEEE
EEEEEWCWWEEEEEEEEEEWWCWEEEEE
EEEEEWCWWEWWWWWWWWEWWCWEEEEE
WWWWWWCWWEWWWWWWWWEWWCWWWWWW
WCCCCCCCCCCCCWWCCCCCCCCCCCCW
WCWWWWCWWWWWCWWCWWWWWCWWWWCW
WCWWWWCWWWWWCWWCWWWWWCWWWWCW
WSCCWWCCCCCCCEMCCCCCCCWWCCSW
WWWCWWCWWCWWWWWWWWCWWCWWCWWW
WWWCWWCWWCWWWWWWWWCWWCWWCWWW
WCCCCCCWWCCCCWWCCCCWWCCCCCCW
WCWWWWWWWWWWCWWCWWWWWWWWWWCW
WCWWWWWWWWWWCWWCWWWWWWWWWWCW
WCCCCCCCCCCCCCCCCCCCCCCCCCCW
WWWWWWWWWWWWWWWWWWWWWWWWWWWW
EEEEEEEEEEEEEEEEEEEEEEEEEEEE