WWWWWWWWWWWWWWWWWWWWWWWWWWWW
CCCCCCCWWCCCCCCCCCCWWCCCCCCC
WWWWWWCWWCWWWWWWWWCWWCWWWWWW
WWWWWWCWWCWWWWWWWWCWWCWWWWWW
WSCCCCCCCCCCCWWCCCCCCCCCCCSW
WCWWWWWWWCWWCWWCWWCWWWWWWWCW
WCWWWWWWWCWWCWWCWWCWWWWWWWCW
WCWWCCCCCCWWCWWCWWCCCCCCWWCW
WCWWCWWWWCWWCWWCWWCWWWWCWWCW
WCWWCWWWWCWWCCCCWWCWWWWCWWCW
WCCCCCCWWCWWWWWWWWCWWCCCCCCW
WWWWWWCWWEEEEEREEEEWWCWWWWWW
WWWWWWCWWEWWWEEWWWEWWCWWWWWW
WCCCCCCWWEWEEEEEEWEWWCCCCCCW
WCWWWWCWWEWEBEPEYWEWWCWWWWCW
WCWWWWCEEEWEEEEEEWEEECWWWWCW
WCCCWWCWWEWWWWWWWWEWWCWWCCCW
WWWCWWCWWEEEEEEEEEEWWCWWCWWW
EEWCWWCWWWWEWWWWEWWWWCWWCWEE
EEWCWWCWWWWEWWWWEWWWWEWWCWEE
EEWCCCCCCCCCWWWWCCCCCCCCCWEE
WWWCWWWWWWWCWWWWCWWWWWWWCWWW
WWWCWWWWWWWCWWWWCWWWWWWWCWWW
EEECEEEWWCCCCEMECCCWWEEECEEE
WWWCWWEWWCWWWWWWWWCWWEWWCWWW
WWWCWWEWWCWWWWWWWWCWWEWWCWWW
WSCCWWCCCCCCCWWCCCCCCCWWCCSW
WCWWWWCWWWWWCWWCWWWWWCWWWWCW
WCWWWWCWWWWWCWWCWWWWWCWWWWCW
WCCCCCCCCCCCCCCCCCCCCCCCCCCW
WWWWWWWWWWWWWWWWWWWWWWWWWWWW