WWWWWWWWWWWWWWWWWWWWWWWWWWWW
WCCCSCCCCCCCCCCCCCCCCCCSCCCW
WCWWWWWWWCWWWWWWWWCWWWWWWWCW
WCWWWWWWWCWWWWWWWWCWWWWWWWCW
WCCCCCCCCCWWCCCCWWCCCCCCCCCW
WCCCCCCCCCWWCWWCWWCCCCCCCCCW
WCWWWWCWWCWWCWWCWWCWWCWWWWCW
WCWWWWCWWCWWCWWCWWCWWCWWWWCW
WCCCCCCWWCCCCWWCCCCWWCCCCCCW
WWWCWWWWWWWWCWWCWWWWWWWWCWWW
EEWCWWWWWWWWCWWCWWWWWWWWCWEE
EEWCCCCWWEEEEEREEEEWWCCCCWEE
WWWCWWCWWEWWWEEWWWEWWCWWCWWW
CCCCWWCWWEWEEEEEEWEWWCWWCCCC
WWWWWWCEEEWEBEPEYWEEECWWWWWW
WWWWWWCWWEWEEEEEEWEWWCWWWWWW
CCCCWWCWWEWWWWWWWWEWWCWWCCCC
WCCCWWCWWEEEEEEEEEEWWCWWCCCW
WCCCCCCWWWWEEWWEWWWWWCCCCCCW
WCCCWWCWWWWEEWWEWWWWWCWWCCCW
WCCCWWCCCCCCCWWCCCCCCCWWCCCW
WCWWWWWWWCWWCWWCWWCWWWWWWWCW
WCWWWWWWWCWWCWWCWWCWWWWWWWCW
WCCCCCCCCCWWCEMCWWCCCCCCCCCW
WCWWWWCWWWWWWWWWWWWWWCWWWWCW
WCWWWWCWWWWWWWWWWWWWWCWWWWCW
WCWWSCCWWCCCCCCCCCCWWCCSWWCW
WCWWCWWWWWWWCWWCWWWWWWWCWWCW
WCWWCWWWWWWWCWWCWWWWWWWCWWCW
WCCCCCCCCCCCCWWCCCCCCCCCCCCW
WWWWWWWWWWWWWWWWWWWWWWWWWWWW
